{
    "上": 0,
    "海": 1,
    "市": 2,
    "黄": 3,
    "浦": 4,
    "区": 5,
    "徐": 6,
    "汇": 7,
    "长": 8,
    "宁": 9,
    "静": 10,
    "安": 11,
    "普": 12,
    "陀": 13,
    "虹": 14,
    "口": 15,
    "杨": 16,
    "东": 17,
    "新": 18,
    "闵": 19,
    "行": 20,
    "宝": 21,
    "山": 22,
    "嘉": 23,
    "定": 24,
    "金": 25,
    "松": 26,
    "江": 27,
    "青": 28,
    "奉": 29,
    "贤": 30,
    "崇": 31,
    "明": 32,
    "交": 33,
    "通": 34,
    "大": 35,
    "学": 36,
    "复": 37,
    "旦": 38,
    "同": 39,
    "济": 40,
    "华": 41,
    "师": 42,
    "范": 43,
    "北": 44,
    "京": 45,
    "天": 46,
    "津": 47,
    "重": 48,
    "庆": 49
}